|Mortal Fea!|	|Greg Iles|
|Pakistan Papers|	|Yani Shankar Aiyer|
|Muslim Law and the Constitution|	|A M.Bhattacharjea|
|Gulzari Lal Nanda|	|A Peep in the Service of the People: Promilla Kalhan|
|Diana–Princess of Wales|	|A Tribute: Tim Graham|
|Mohandas|	|A True Story of a Man, His People and an Empire : Rajmohan Gandhi|
|Faith & Fire|	|A Way Within: Madhu Tandon|
|Divine Comedy|	|A. Dante|
|La Divine Comedia|	|A. Dante|
|Beyond Autonomy-Roots of India's Foreign Policy|	|A. K. Damodaran|
|Jawaharlal Nehru–A Communicator & Democratic Leader|	|A. K. Damodran|
|Lotus Eaters|	|A. Tennvson|
|Diplomacy for the Next Century|	|Abba Eban|
|The Believers|	|Abdul Sultan P. P.|
|Ain-i-Akbari|	|Abul Fazal|
|Akbarnama|	|Abul Fazal|
|Islamic Seal on India's Independence|	|Abul Kalam Azad–A Fresh Look : Syede Saiyiadan Hameed|
|Beginning of the Beginning|	|Acharya Rajneesh|
|Returning to the Source|	|Acharya Rajneesh|
|Agni Pariksha|	|Acharya Tulsi|
|Hold Back the Night|	|Adam Baran|
|An Inquiry into the Nature and Causes of the Wealth of Nations|	|Adam Smith|
|Falling Leaves Return to Their Roots|	|Adeline Yen Man|
|Mein Kampf|	|Adolf Hitler|
|Death on the Nile|	|Agatha Christie|
|Murder on the Orient Express|	|Agatha Christie|
|Taliban-Islam-Oil and the New Great Game in Central Asia|	|Ahmed Rashid|
|Social Justice & the Constitution|	|Ajit Bhattacharjea|
|Kashmir–The Wounded Valley|	|Ajit Bhattacharjee|
|Earth in the Balance–Forging a New Common Purpose|	|Al Gore|
|Storm in the Sea Wind–Ambani Vs Ambani|	|Alam Srinivas|
|The A-Z of Bradman|	|Alan Eason|
|Cry, My Beloved Country|	|Alan Paton|
|Exile and the Kingdom|	|Albert Camus|
|Happy Death|	|Albert Camus|
|La Peste|	|Albert Camus|
|Myth of Sisyphus|	|Albert Camus|
|Inside the Third Reich|	|Albert Spencer|
|Tahqiq-i-Hind|	|Alberuni|
|Along the Road|	|Aldous Huxley|
|Antic Hay|	|Aldous Huxley|
|Ape and Essence|	|Aldous Huxley|
|Ends and Means|	|Aldous Huxley|
|Eyeless in Gaza|	|Aldous Huxley|
|Grey Eminence|	|Aldous Huxley|
|A Captain's Diary|	|Alec Stewart|
|Indian Summer–The Secret History of the end of an Empire|	|Alex Von|
|The Count of Monte Cristo|	|Alexander Dumas|
|Cancer Ward|	|Alexander Solzhenitsyn|
|Candle in the Wind|	|Alexander Solzhenitsyn|
|First Circle|	|Alexander Solzhenitsyn|
|Gulag Archipelago|	|Alexander Solzhenitsyn|
|Inferno|	|Alighieri Dante|
|Paradise|	|Alighieri Dante|
|Purgatory|	|Alighieri Dante|
|Everest Hotel|	|Allan Sealey|
|Loneliness of the Long Distance Runner|	|Allan Sillitoe|
|Advice and Consent|	|Allen Drury|
|Revolutionary Wealth|	|Alvin and Heidi Toffler|
|Horizons–The Tata India Century|	|Aman Nath, Jay Vithalani, Tulsi Vatsal|
|Lest We Forget|	|Amarinder Singh|
|Development As Freedom|	|Amartya Sen|
|Development with Dignity-A Case for Full Employment|	|Amit Bhaduri|
|A New World|	|Amit Chaudhuri|
|Freedom Song|	|Amit Chaudhuri|
|Real Time|	|Amit Chaudhuri|
|St. Cyril Road|	|Amit Chaudhuri|
|Glass Palace|	|Amitabha Ghosh|
|Circle of Reason|	|Amitav Ghosh|
|The Calcutta Chromosome|	|Amitav Ghosh|
|Husband of a Fanatic|	|Amitava Kumar|
|On the Edge of a Century|	|Amlan Datta|
|Netaji Subhash–Ideology & Doctrine|	|Amlendu Guha|
|Kasturba–A Life|	|Amn Gandhi|
|Finding a Voice–Asian Women in Britain|	|Amrit Wilson|
|Death of a City|	|Amrita Pritam|
|Fortynine Days|	|Amrita Pritam|
|Kagaz Te Kanwas|	|Amrita Pritam|
|Kore Kagaz|	|Amrita Pritam|
|Pinjar|	|Amrita Pritam|
|In Confidence|	|Anatolyu Dobrynin|
|Ideology and Social Science|	|Andre Beteille|
|Small Island|	|Andrea Levy|
|Climate of Treason|	|Andrew Boyle|
|Being Freddie|	|Andrew Flintoff|
|Diana–Her Time Story in Her Own Words|	|Andrew Martin|
|Diana–The True Story|	|Andrew Morton|
|Our Fathers|	|Andrew O'Hagan|
|Eminent Churchillians|	|Andrew Roberts|
|Breaking the Silence|	|Anees Jung|
|Internet–The Rough Guide|	|Angus J. Kennedy|
|IC 814 Hijacked|	|Anil Jaggia & Saurabh Shukla|
|Crescent Over Kashmir|	|Anil Maheshwari|
|Failing Slowly|	|Anita Brookner|
|A Village by the Sea|	|Anita Desai|
|Clear Light of Day|	|Anita Desai|
|Fasting, Feasting|	|Anita Desai|
|Listening Now|	|Anjana Apachana|
|Princess in Love|	|Ann Pasternak|
|Birth and Evolution of the Soul|	|Annie Besant|
|Death and Mter|	|Annie Besant|
|Nothing Like The sun|	|Anthony Bugess|
|Clockwork Orange|	|Anthony Burgess|
|Rape of Bangladesh|	|Anthony Mascarenhas|
|Mandela–The Authorised Biography|	|Anthony Sampson|
|Heritage|	|Anthony West|
|Ivanov|	|Anton Chekhov|
|Lady with the Lapdog|	|Anton Chekhov|
|In Search of Identity|	|Anwar el-Sadat|
|Eternity|	|Anwar Shaikh|
|Fifty Years of Indian Management–An Insider's View|	|Arabinda Roy|
|Beach Boy|	|Ardesher Vakil|
|Count Your Chickens Before They Hatch|	|Arindam Chaudhuri|
|Athenian Constitution|	|Aristotle|
|Ethics|	|Aristotle|
|Metaphysics|	|Aristotle|
|Politics|	|Aristotle|
|A. Study of History|	|Arnold Toynbee|
|Mankind and Mother Earth|	|Arnold Toynbee|
|One World and India|	|Arnold Toynbee|
|Nuclear Deterrence in Southern Asia–China, India & Pakistan|	|Arpit Rajan|
|Days of Grace|	|Arthur Ashe & Arnold Rampersad|
|Rendezvous with Rama|	|Arthur C. Clark|
|Airport|	|Arthur Hailey|
|Detective|	|Arthur Hailey|
|Arrival and Departure|	|Arthur Koestler|
|Arrow in the Blue|	|Arthur Koestler|
|Darkness at Noon|	|Arthur Koestler|
|Dialogue With Death|	|Arthur Koestler|
|Ghosts in the Machine|	|Arthur Koestler|
|Gladiators|	|Arthur Koestler|
|A Thousand Days|	|Arthur M. Schlesinger|
|Expanding Universe|	|Arthur Stanley Eddington|
|The Black Economy in India|	|Arun Kumar|
|A Secular Agenda|	|Arun Shourie|
|Courts and Their Judgements|	|Arun Shourie|
|Mrs. Gandhi's Second Reign|	|Arun Shourie|
|Governance and the Sclerosis that has set in|	|Arun Shourie|
|Algebra of Infinite Justice|	|Arundhati Roy|
|An American in Khadi|	|Asha Sharma|
|One Day Cricket–The Indian Challenge|	|Ashis Roy|
|Growing Old In India–Voices Reveal, Statistics Speak|	|Ashish Bose & Mala Kapur Shanker Dass|
|Stability in South Asia|	|Ashley J. Tellis|
|A Billion is Enough|	|Ashok Gupta|
|Economic Planning of India|	|Ashok Mehta|
|Buddha Charitam|	|Ashvaghosha|
|Laws, Ideas and Ideology in Politics–Perspective of an Activist|	|Ashwani Kumar|
|New Dimensions of India's Foreign Policy|	|Atal Bihari Vajpayee|
|Freedom from Fear|	|Atmg San Suu Kyi|
|Essays on Gita|	|Aurobindo Ghosh|
|Life Divine|	|Aurobindo Ghosh|
|Savitri|	|Aurobindo Ghosh|
|Things|	|Avtar Singh.|
|India's Neighbours–Problems And Prospects|	|Ayanjit Sen|
|M.A. Jinnah|	|Ayesha Jalal|
|Friends, Not Masters|	|Ayub Khan|
|A Cabinet Secretary Looks Back|	|B. G. Deshmukh .|
|Godrej–A Hundred Years|	|B. K. Karanjia|
|Bofors The Ambassador's Evidence|	|B. M. Oza|
|Chinese Betrayal|	|B. N. Mullick|
|PMO Diary-I, Prelude Emergency|	|B. N. Tandon|
|India's Culture, the State, the Arts & Beyond|	|B. P. Singh|
|Jawaharlal Nehru, Rebel and Statesman|	|B. R. N anda|
|Nice Guys Finish Second|	|B.K Nehru|
|Gita Rahasya|	|Bal Gangadhar Tilak|
|Harsha Charita|	|Bana Bhatt|
|Kadambari|	|Bana Bhatt|
|Anandmath|	|Bankim Chandra Chatterjee|
|Durgesh Nandini|	|Bankim Chandra Chatterjee|
|Kapal Kundala|	|Bankim Chandra Chatterjee|
|Mrinalini|	|Bankim Chandra Chatterjee|
|Radharani|	|Bankim Chandra Chatterjee|
|Bishbriksha|	|Bankim Chandra Chatterji|
|Dreams From My Father|	|Barack Obama |
|India–Facing the Twenty–First Century|	|Barbara Crossette|
|A. Sudden Change of Hearts|	|Barbara Taylor|
|Facing Up|	|Bear Grylls|
|Inconceivable|	|Ben Elton|
|Humour|	|Ben Johnson|
|Stars of New Curfew|	|Ben Okri|
|Daughter of the East|	|Benazir Bhutto|
|Pakistan–The Gathering Storm|	|Benazir Bhutto|
|Grace Notes|	|Bernard Mac Lavarto|
|Conquest of Happiness|	|Bertrand Russell|
|Free Man's Worship|	|Bertrand Russell|
|Human Knowledge|	|Bertrand Russell|
|Marriage and Morals|	|Bertrand Russell|
|A Dream in Hawaii|	|Bhabani Bhattacharya|
|Shadow from Ladakh|	|Bhabani Bhattacharya|
|Return of the Aryans|	|Bhagwan S. Gidwani|
|Natya Shastra|	|Bharat Muni|
|Swapnavasvadatta|	|Bhasa|
|Malti Madhav|	|Bhavabhuti|
|Notes from a Big. Country|	|Bill Bryson|
|Notes from a Small Island|	|Bill Bryson|
|Between Hope and History|	|Bill Clinton|
|My Life|	|Bill Clinton|
|Bearders–My Life in Cricket|	|Bill Frindall|
|Business at the Speed of Thought|	|Bill Gates|
|India's Politics–A View From the Backbench|	|Bimal Jalan|
|Don't Laugh–We are Police|	|Bishan Lal Vohra|
|Global Crises-Global Solutions|	|Bjorn Lombarg|
|Men from Stone Age to Clone Age|	|Bob Beale|
|The Agenda–Inside the Clinton White House|	|Bob Woodward|
|Struggles of Indian Federalism|	|Bonica Aleaz|
|Blind Beauty|	|Boris Pasternak|
|Dr. Zhivago|	|Boris Pasternak|
|Against the Grain|	|Boris Yeltsin|
|Midnight Diaries|	|Boris Yeltsin|
|Mangal Pandey|	|Brave Martyr or Accidental Hero? : Rudrangashu Mukherjee|
|Sacked or Sunk ? Admiral Vishnu Bhagwat|	|Brigadier R. P. Singh & Comdre Ranjit B. Rao|
|Follywood Flashback|	|Bwmy Reuben|
|Death Under Sail|	|C. P. Snow|
|Hamsters|	|C. P. Snow|
|Home Comings|	|C. P. Snow|
|Last Things|	|C. P. Snow|
|Strangers and Brothers Omnibus|	|C. P. Snow|
|The Affairs|	|C. P. Snow|
|Lal Bahadur Shastri|	|C. P. Srivastava|
|Iron Harvest|	|C. P. Surendran|
|Crossing the Rubicon|	|C. Raja Mohan|
|Impossible Allies|	|C. Raja Mohan|
|End of an Era|	|C. S. Pandit|
|Sex, Art and American Culture|	|Camille Paglia|
|A Ridge Too Far|	|Captain Amarinder Singh|
|Fights Into Fear|	|Captain Devi Sharan|
|Flight into Fear|	|Captain Devi Sharan & Srijoy Chowdhury|
|Lead Kindly Light|	|Cardinal Newman|
|All the President's Men|	|Carl Bernstein and Bob Woodward|
|Crossing the River|	|Caryl Phillips|
|Final Passage|	|Caryl Phillips|
|Edwina and Nehru|	|Catherine Clement|
|The Crown and the Loincloth|	|Chaman Nahal|
|The Corrupt Society|	|Chandan Mitra|
|Prithviraj Raso|	|Chandra Bardai|
|Dynamics of Social Change|	|Chandra Shekhar|
|Chakori|	|Chandrasekhar Kamba|
|Descent of Man|	|Charks Darwin|
|Bermuda Triangle|	|Charles Berlitz|
|Origin of Species|	|Charles Darwin|
|Power of Movement in Plants|	|Charles Darwin|
|Memories of Hope|	|Charles de Gaulle|
|A Tale of Two Cities|	|Charles Dickens|
|Bleak House|	|Charles Dickens|
|Christmas Tales|	|Charles Dickens|
|Cricket on the Hearth|	|Charles Dickens|
|David Copperfield|	|Charles Dickens|
|Great Expectations|	|Charles Dickens|
|Hard Times|	|Charles Dickens|
|Nicholas Nickelby|	|Charles Dickens|
|Old Curiosity Shop|	|Charles Dickens|
|Oliver Twist|	|Charles Dickens|
|Pickwick Papers|	|Charles Dickens|
|Essays of Elia|	|Charles Lamb|
|Tales from Shakespeare|	|Charles Lamb|
|Jane Eyre|	|Charlotte Bronte|
|Promises to Keep|	|Chester Bowels'|
|A View from Delhi|	|Chester Bowles|
|Ambassador's Report|	|Chester Bowles|
|India is for Sale|	|Chitra Subramaniam|
|The Black Pharaoh|	|Christian Jacq|
|Jack and Jackie–Portrait of an American Marriage|	|Christopher Anderson|
|For the President's Eyes Only|	|Christopher Andrew|
|Doctor Faustus|	|Christopher Marlowe|
|Numbered Account|	|Christopher Reich|
|Pakistan's Failed Gamble|	|Col. (Retd.) Anil Shourie|
|Remorseful Day|	|Colin Dexter|
|The Blackwater Lightship|	|Colm Toibin|
|Kargil War–Past, Present & Future|	|Colonel (Rtd.) Bhaskar Sarkar|
|Naku Thanthi|	|D R. Bendre|
|Lady Chatterley's Lover|	|D. H. Lawrence|
|Sons and Lovers|	|D. H. Lawrence|
|India's March to Freedom; The Nehru Epoch; The Post Nehru Era|	|D. P. Mishra|
|Pakistan Cut to Size|	|D. R. Mankekar|
|Decline and Fall of Indira Gandhi|	|D. R. Mankekar and Kamala Mankekar|
|50 Years of India's Independence|	|D. S. Subramaniam|
|Ethics for New Millennium|	|Dalai Lama|
|Freedom in Exile|	|Dalai Lama|
|How to Win Friends and Influence People|	|Dale Carnegie|
|Dashkumar Charitam|	|Dandi|
|Adventures of Robinson Crusoe|	|Daniel Defoe|
|A Dangerous Place|	|Daniel Patrick Moynihan|
|Communalism-Handled with a Difference|	|Daniel Steel|
|Lighting|	|Danielie Steel|
|Granny Dan|	|Danielle Steel|
|Jewel|	|Danielle Steel|
|Long Road Home|	|Danielle Steel|
|MirrorImage|	|Danielle Steel|
|Corporate Governance, Economic Reforms & Development|	|Darryl Reed and Sanjoy Mukherjee|
|Saving Faith|	|David Baldacci|
|My Side|	|David Beckham|
|Power That Be|	|David Halberstan|
|An Enquiry Concerning Human Understanding|	|David Hume|
|Pakistan Crisis|	|David Loshak|
|Remembering Babylon|	|David Malouf|
|An Eye to China|	|David Selbourne|
|Ageless Body; Timeless Mind|	|Deepak Chopra|
|Estranged Democracies|	|Dennis Kux|
|Sole Survivor|	|Derek Hansen|
|Another Life|	|Derek Walcott|
|Omeros|	|Derek Walcott|
|South from the Limpopo; Travels Through South Africa|	|Dervla Murphy|
|False Witness|	|Dexter Dias|
|The Contemporary Conservative|	|Dhiren Bhagat|
|Second Wind|	|Dick Francis|
|Inside the Olympics|	|Dick Pound|
|Branded by Law|	|Dilip D'Souza|
|Scarred–Experiments with Violence in Gujarat|	|Dionne Bunsha|
|Ethics Incorporated|	|Dipankar Gupta|
|Learning to Forget–The Anti¬Memoirs of Modernity|	|Dipankar Gupta|
|My Son's Father|	|Dom Moraes|
|Never At Home|	|Dom Moraes|
|A Thousand Suns|	|Dominique Lapierre|
|City of Joy|	|Dominique Lapierre|
|Is New York Burning?|	|Dominique Lapierre & Larry Collins|
|Guiding Souls-Dialogues on the Purpose of Life.|	|Dr. A. P. J. Abdul Kalam and Arun K. Tiwari|
|Indomitable Spirit|	|Dr. A.P.J. Abdul Kalam|
|The Argumentative Indian|	|Dr. Amartya Sen|
|Intelligence Services|	|Dr. Bhashyam Kasturi|
|India's Economic Crisis|	|Dr. Bimal Jalan|
|Indian Economy–Essay on Money and Finance|	|Dr. C. Rangarajan|
|Platform No. Chaar|	|Dr. Himanshi Shelat|
|Ramanujar|	|Dr. Indira Parthasarathy|
|A Doctor's Story of Life and Death|	|Dr. Kakkana Subbarao & Arun K. Tiwari|
|God as Political Philosopher–Buddha's Challenge to Brahminism|	|Dr. Kanchan Illaiah|
|Heir Apparent|	|Dr. Karan Singh|
|In the Mternqon of Time|	|Dr. Rupert Snell|
|Indian Philosophy|	|Dr. S. Radhakrishnan|
|An Idealist View of Life|	|Dr. S.Radhakrishnan|
|Tehriq-e-Mujahideen|	|Dr. Sadiq Hussain|
|100 Best Parliamentary Speeches–1947-97|	|Dr. Subhash C. Kashyap|
|An Unfinished Dream|	|Dr. Verghese Kurien|
|I Too Had A Dream|	|Dr. Verghese Kurien|
|India–From Curzon to Nehru and Mter|	|Durga Dass|
|Guide for the Perplexed|	|E. F. Schumacher|
|My Struggles|	|E. K. Nayanar|
|Ragtime|	|E. L. Doctorow|
|A Passage to India|	|E. M. Forster|
|Aspects of the Novel|	|E. M. Forster|
|Maurice|	|E. M. Forster|
|Crisis into Chaos|	|E.M.S. Narnboodiripad|
|Tarzan of the Apes|	|Edgar Rice Burroughs|
|Red Star Over China|	|Edgar Snow|
|Reflections on the French Revolution|	|Edmund Burke|
|Stalin|	|Edvard Radzinsky|
|Rubaiyat-i-Omar Khayyam|	|Edward Fitzgerald|
|Last Days of Pompeii|	|Edward George Lytton|
|Decline and Fall of the Roman Empire|	|Edward Gibbon|
|Die Blendung|	|Elias Canetti|
|Debacle|	|Emile Zola|
|Drunkard|	|Emile Zola|
|Earth|	|Emile Zola|
|His Excellency|	|Emile Zola|
|Nana|	|Emile Zola|
|Peculiar Music|	|Emily Bronte|
|Children in Globalising India– Challenging Our Conscience|	|Enkashi Ganguly Thukral|
|On History|	|Eric Hobsbawm|
|The Age of Extremes|	|Eric Hobsbawm|
|Dark Home Coming|	|Eric Lustbader|
|Heaven Has No Favourites|	|Eric Maria Remarque|
|Love Story|	|Eric Segal|
|Growing up in Anglo-India|	|Eric Stracey|
|All Quiet on the Western Front|	|Erich Maria Remarque|
|Oliver's Story|	|Erich Segal|
|The Class|	|Erich Segal|
|A Farewell to Arms|	|Ernest Hemingway|
|Fiesta|	|Ernest Hemingway|
|Fifth Column|	|Ernest Hemingway|
|For Whom the Bell Tolls|	|Ernest Hemingway|
|Islands in the Streams|	|Ernest Hemingway|
|The Dangerous Summer|	|Ernest Hemingway|
|Envoy to Nehru|	|Escott Reid|
|Beyond the Horizons|	|Eugene O'Neill|
|Long Day's Journey into Night|	|Eugene O'Neill|
|A Handful of Dust|	|Evelyn Waugh|
|Days of His Grace|	|Eyvind Johnson|
|Dreams,Roses and Fire|	|Eyvind Johnson|
|Great Gatsby|	|F. Scott Fitzgerald|
|Higher than Hope|	|Fatima Meer|
|Shahnama|	|Firdausi|
|The Castle|	|Franz Kafka|
|The Day of the Jackal|	|Frederick Forsyth|
|Beyond Good and Evil|	|Friedrich Nietzsche|
|House of the Dead|	|Fyodor Dostoevsky|
|Crime and Punishment|	|Fyodor M. Dostoevsky|
|Insulted and the Injured|	|Fyodor M. Dostoevsky|
|Man for Moscow|	|G Wynne|
|Nuclear India|	|G. G. Mirchandani and P. K S. Namboodari|
|Past Forward|	|G. R. Narayanan|
|Oddakkuzal|	|G. Shankara Kurup|
|Chronicle of a Death Foretold|	|Gabriel Garcia Marquez|
|In Evil Hour|	|Gabriel Garcia Marquez|
|One Hundred Years of Solitude|	|Gabriel Marquez|
|Soul Mountain|	|Gao Xingjian Mabel Lee|
|Dateline Kargil|	|Gaurav C. Samant|
|Reverse Sweep–Confessions of a Cricket Junkie|	|Gautam Bhimani|
|Kashmir Diary–Psychology of Militancy|	|Gen. Arjun Ray|
|Confrontation with Pakistan|	|Gen. B. M. Kaul|
|Blind Men of Hindoostan–Indo–Pak Nuclear War|	|Gen. Krishnaswamy Sundarji|
|Breakthrough|	|Gen. Moshe Dayan|
|Kargil–From Surprise to Victory|	|Gen. V. P. Malik|
|Of Some Consequence–A Soldier Remembers|	|General K. Sundarji|
|The Canterbury Tales|	|Geoffery Chaucer|
|Franklin's Tale|	|Geoffrey Chaucer|
|Man of Destiny|	|George Bernard|
|Apple Cart|	|George Bernard Shaw|
|Arms and the Man|	|George Bernard Shaw|
|Back to Methuselah|	|George Bernard Shaw|
|Caesar and Cleopatra|	|George Bernard Shaw|
|Candida|	|George Bernard Shaw|
|Doctor's Dilemma|	|George Bernard Shaw|
|Major Barbara|	|George Bernard Shaw|
|Man and Superman|	|George Bernard Shaw|
|Pygmalion|	|George Bernard Shaw|
|St. Joan|	|George Bernard Shaw|
|Childe Harold's Pilgrimage|	|George Byron|
|Don Juan|	|George Byrqn|
|Adam Bede|	|George Eliot|
|Daniel Deronda|	|George Eliot|
|Middle March|	|George Eliot|
|Mill on the Floss|	|George Eliot|
|Silas Marner|	|George Eliot|
|Birth and Death of the Sun|	|George Gamow|
|Raga Mala–Autobiography of Ravi Shankar|	|George Harrison|
|Farm House|	|George Orwell|
|Nineteen Eighty-Four (1984)|	|George Orwell|
|The Animal Farm|	|George Orwell|
|Diplomacy and Disillusion|	|George Urbans|
|Kulliyat|	|Ghalib|
|Jungle Girl|	|Ginu Karnani|
|Decameron|	|Giovanni Boccaccio|
|Main Waqt Ke Hoon Samane|	|Girija Kumar Mathur|
|Hayavadana|	|Girish Karnad|
|Slumming India|	|Gita Dewan Verma|
|A River Sutra|	|Gita Mehta|
|Snakes & Ladders–A View of Modern India|	|Gita Mehta|
|Business Legends|	|Gita Piramal|
|Mati Matal|	|Gopinath Mohanty|
|Creation|	|Gore Vidal|
|Bharatiya Parampara Ke Mool Swar|	|Govind Chandra Pande|
|CBK|	|Graeme Wilson|
|Human Factor|	|Graham Greene|
|Living Room|	|Graham Greene|
|Power and Glory|	|Graham Greene|
|Last Orders|	|Graham Swift|
|Great One-Day Internationals|	|Gulu Ezekiel|
|Ravi Paar (Across the Ravi)|	|Gulzar|
|An American Dilemma|	|Gunnar Myrdal|
|Asian Drama|	|Gunnar Myrdal|
|India Unbound|	|Gurcharan Das|
|A Woman's Life|	|Guy de Maupassant|
|Routine Violence|	|Gyanendra Pandey|
|Echoes from Old Calcutta|	|H. E. Busteed|
|Kipps|	|H. G. Wells|
|Shape of Things to Come|	|H. G. Wells|
|Days of My Years|	|H. P. Nanda|
|Law, Lawyers & Judges|	|H. R. Bhardwaj|
|The Book I Won't Be Writing And Other Essays|	|H. Y. Sharda Prasad|
|Love in a Blue Time|	|Hanif Khureshi|
|Nehru Family and Sikhs|	|Harbans Singh|
|Rukh Te Rishi|	|Harbhajan Singh|
|Kashmir–A Tale of Shame|	|Hari Jaisingh|
|Prateeksha|	|Harivansh Rai Bachchan|
|Dilemma of Our Time|	|Harold Joseph La ski|
|Grammar of Politics|	|Harold Joseph Laski|
|Riding the Storm|	|Harold MacMillan|
|Ratnavali|	|Harsha Vardhan|
|Niti-Sataka|	|Bhartrihari|
|Studies in the Psychology of Sex|	|Havelock Ellis|
|The Clown|	|Heinrich Boll|
|A Doll's House|	|Henrik Ibsen|
|Amelia|	|Henry Fielding|
|Author's Farce|	|Henry Fielding|
|Grub Street|	|Henry Fielding|
|Diplomacy|	|Henry Kissinger|
|Tears of Renewal|	|Henry Kissinger|
|The Cardinal|	|Henry Morton Robinson|
|Management and Cultural Values|	|Henry S. R. Kao|
|Moby Dick|	|Herman Melville|
|Siddharta|	|Hermann Hesse|
|Odyssey|	|Homer|
|Black Sheep|	|Honore de Balzac|
|Eugenie Grandet|	|Honore de Balzac|
|Harlot High and Low|	|Honore de Balzac|
|Lost Illusion|	|Honore de Balzac|
|Murky Business|	|Honore de Balzac|
|Old Goriot|	|Honore de Balzac|
|South-East Asia on a Shoestring|	|Hugh Finlay|
|The Banyan Tree|	|Hugh Tinker|
|Naari|	|Humavun Azad|
|Kashmir, the Untold Story|	|Humra Qureshi|
|Pakistan Between Mosque and Military|	|Hussain Haqqani|
|India We Left|	|Hymphry Trevelyan|
|India's Economic Reforms and Development Essays for Manmohan Singh|	|I. J. Ahluwalia & I. M. D. Little|
|A Foreign Policy for India|	|I. K. Gujral|
|Hindu-Muslim Unity|	|Ian Bryant Wells|
|Headlong|	|Michael Frayen|
|A Critique of Pure Reason|	|Immanuel Kant|
|The Critique of Pure Reason|	|Immanuel Kant|
|My Truth|	|Indira Gandhi|
|Missed Opportunities|	|Indo-Pak War 1965 : Major General Lakshman Singh|
|Island in Chains|	|Indres Naidoo|
|Memoirs of a Bystander–Life in Diplomacy|	|Iqbal Akhund|
|Adversary in the House|	|Irving Stone|
|The Agony and the Ecstasy|	|Irving Stone|
|Principia|	|Isaac Newton|
|Nurturing Development|	|Ismail Serageldin|
|Family Moskat|	|Issac Bashevis Singer|
|Father and Sons.|	|Ivan Turgenev|
|Educational Reforms in India–For the 21st Century|	|J. C. Aggarwal|
|History|	|J. C. Daniel|
|Confessions|	|J. J. Rousseau|
|Emile|	|J. J. Rousseau|
|Le Contract Social (The Social Contract)|	|J. J. Rousseau|
|Ambassador's Journal|	|J. K. Galbraith|
|American Capitalism|	|J. K. Galbraith|
|The Affluent Society|	|J. K. Galbraith|
|Harry Potter and the Deathly Hollows|	|J. K. Rowling|
|Harry Potter and the Goblet of Fire|	|J. K. Rowling|
|Harry Potter and the Half Blood Prince|	|J. K. Rowling|
|Hindu Civilisation|	|J. M. Barrie|
|Peter Pan|	|J. M. Barrie|
|Disgrace|	|J. M. Coetzee|
|Life and Times of Michael K|	|J. M. Coetzee|
|Assignment Colombo|	|J. N. Dixit|
|My South Block Years|	|J. N. Dixit|
|Diplomacy in Peace and War|	|J. N. Kaul|
|Himalayan Blunder|	|J. P. Dalvi|
|Faust|	|J. W Von Goethe|
|Egmont|	|J. W. Von Goethe|
|Ironhand|	|J. W. Von Goethe|
|Pay the Devil|	|Jack Higgins|
|Differentiate or Die|	|Jack Trout & Steve Rivkin .|
|My Life in Action|	|Jackie Chan|
|In Defence Qf Globalisation|	|Jagdish Bhagwaci|
|A Stream of Windows–Unsettling Reflections on Trade, Imigration and Democracy|	|Jagdish Bhagwati|
|Soul And Structure of Governance in India|	|Jagmohan|
|Ajatshatru|	|Jai Shankar Prasad|
|Kamayani|	|Jai Shankar Prasad|
|Making Sense of Chindia–Reflections on China & India|	|Jairam Ramesh|
|Caravans|	|James A. Michener|
|All Things Bright and Beautiful|	|James HerrQit|
|Goodbye, Mr. Chips|	|James Hilton|
|Mysterious Universe|	|James Jeans|
|From Here to Eternity|	|James Jones|
|How Late It .Was, How Late|	|James Kelman|
|Shivaji–Hindu King of Islamic India|	|James Laine|
|Centennial|	|James lvIichener|
|Farewell the Trumpets|	|James Morris|
|Betrayal of Pearl Harbour|	|James Rusbridger and Eric Nave|
|Blood Sport|	|James Stewart|
|Diana Versus Charles|	|James Whitaker|
|Khak-i-Dil|	|Jan Nissar Akhtar|
|All the Prime Minister's Men|	|Janardhan Thakur|
|Emma|	|Jane Austen|
|Mansfield Park|	|Jane Austen|
|Northanger Abbey|	|Jane Austen|
|Persuasion|	|Jane Austen|
|Pride and Prejudice|	|Jane Austen|
|Sense and Sensibility|	|Jane Austen|
|A Call To Honour-In Service of Emergent India|	|Jaswant Singh|
|Tarkash|	|Javed Akhtar|
|The Cutting Edge|	|Javed Miandad|
|Discovery of India|	|Jawahadal Nehru|
|A Bunch of Old Letters|	|Jawaharlal Nehru|
|An Autobiography|	|Jawaharlal Nehru|
|Glimpses of World History|	|Jawaharlal Nehru|
|Geet Govinda|	|Jaya Dev|
|Prison Diary|	|Jayaprakash Narayan|
|Gita Govinda|	|Jaydev|
|From Raj to the Republic–A Political History of India|	|Jean Alphonse Bernard|
|Age of Reason|	|Jean Paul Sartre|
|Intimacy|	|Jean Paul Sartre|
|Iron in the Soul|	|Jean Paul Sartre|
|Reprieve|	|Jean Paul Sartre|
|Shall We Tell the President ?|	|Jeffrey Archer|
|Surviving Women|	|Jerry Pinto|
|Maneaters of Kumaon|	|Jim Corbett|
|Temple Tiger|	|Jim Corbett|
|Quarantene|	|Jim Crass|
|Dolly–The Birth of a Clone|	|Jina Kolata|
|Other People's Children|	|Joanna Trollope|
|Inside the CBI|	|Joginder Singh|
|Midnight in the Garden of Good and Evil|	|John Berendt|
|Room at the Top|	|John Braine Roots|
|Life and Death of Mr. Badman|	|John Bunyan|
|Blind Ambitions|	|John Dean|
|Lost Honour|	|John Dean|
|All for Love|	|John Dryden|
|End of the Chapter|	|John Forsyte|
|Escape|	|John Forsyte|
|Fraternity|	|John Forsyte|
|Shaw Man of Property|	|John Galsworthy|
|Strife|	|John Galsworthy|
|Mars & Venus–A Match In Heaven?|	|John Gray|
|Runaway Jury|	|John Grisham|
|Street Lawyer|	|John Grisham|
|The Brethren|	|John Grisham|
|Alexander the Great|	|John Gunther|
|Death Be Not Proud|	|John Gunther|
|Inside Asia (also Inside Europe and Inside Mrica)|	|John Gunther|
|Economics of Peace and Laughter|	|John K. Galbraith|
|Economics of Public Purpose|	|John K. Galbraith|
|Isabella|	|John Keats Islamic Bomb : Stev Weissman and Herbert Krousney|
|India Discovered|	|John Keay|
|A China Passage|	|John Kenneth Galbraith|
|Essays for Poor to the Rich|	|John Kenneth Galbraith|
|Single & Single|	|John Le Carre|
|A Spaniard in the Works|	|John Lennon|
|Nine Days' Wonder|	|John Mansfield|
|Comus|	|John Milton|
|L'Allegro|	|John Milton|
|Lycidas|	|John Milton|
|Paradise Lost|	|John Milton|
|Paradise Regained|	|John Milton|
|Look Back in Anger|	|John Osborne|
|Ink|	|John Preston|
|Modern Painters|	|John Ruskin|
|Sesame and Lilies|	|John Ruskin|
|Seven Lamps of Architecture|	|John Ruskin|
|The Crown of Wild Olive|	|John Ruskin|
|Grapes of Wrath|	|John Steinbeck|
|Considerations on Representative Government|	|John Stuart Mill|
|Rabbit, Run|	|John Updika|
|The Coup|	|John Updike|
|Tunzelmann Indian Summers|	|John Wright|
|A Tale of a Tub|	|Jonathan Swift|
|Gulliver's Travels|	|Jonathan Swift|
|Coverly Papers|	|Joseph Addison|
|Arrow of Gold|	|Joseph Conrad|
|Chance|	|Joseph Conrad|
|Heart of Darkness|	|Joseph Conrad|
|Lord Jim|	|Joseph Conrad|
|Mirror of the Sea|	|Joseph Conrad|
|Mod Classics|	|Joseph Conrad|
|Nostromo|	|Joseph Conrad|
|Secret Agent|	|Joseph Conrad|
|Shadow Line|	|Joseph Conrad|
|Born Free|	|Joy Adamson|
|The Blessing|	|Jude Deveraux|
|Summer Sisters|	|Judy Bloom|
|Around the World in Eighty Days|	|Jules Verne|
|Diana–The Story So Far|	|Julia Donelli|
|Mao, the Unknown Story|	|Jung Chang & Jon Halliday|
|Suu Kyi|	|Justin Wintle|
|Crime & Money Laundering|	|Jyoti Trehan|
|I am Not an Island|	|K. A. Abbas|
|Child and Law in India|	|K. Chandru, Geeta Ramaseshan and Chandra Thanikachalam|
|Press Freedom–The Indian Story|	|K. G. Joglekar|
|Seshan–An Intimate Story|	|K. Govindan Kutty|
|Road to Freedom|	|K. K. Khullar|
|I Follow the Mahatma|	|K. M. Munshi|
|Jai Somnath|	|K. M. Munshi|
|Asia and Western Dominance|	|K. M. Panikkar|
|The Assassination|	|K. Mohandas|
|Curtain Raisers|	|K. Natwar Singh|
|Profiles & Letters|	|K. Natwar Singh|
|Punjab, The Knights of Falsehood|	|K. P. S. Gill|
|Many Worlds|	|K. P. S. Menon|
|India First|	|K. R. Malkani|
|Mughal Maharajas and the Mahatma|	|K. R. N. Swami|
|Subsidies–A Bottomless Bucket|	|K. S. Ramachandran|
|Choma's Drum|	|K. Shivaram Karanth|
|Mookhajjiva Kanasugalu|	|K. Shivram Karanth|
|Japan–South Asia Security and Economic Perspectives|	|K. V Kesvan|
|India's Development As Knowledge Society|	|K. Venkatasubramanian|
|Khushwant Singh–An Icon of Our Age|	|Kaamna Prasad|
|Death–The Supreme Friend|	|Kakasaheb Kalelkar|
|Rajtarangini|	|Kalhana|
|Kumar Sambhava|	|Kalidas|
|Malavikagnimitra|	|Kalidas|
|Meghdoot|	|Kalidas|
|Raghuvamsa|	|Kalidas|
|Ritu Samhara|	|Kalidas|
|Shakuntala|	|Kalidas|
|Abhigyana Shakuntalam|	|Kalidasa|
|Rediscovering Dharavi|	|Kalpana Sharma|
|In the City by the Sea|	|Kamilla Shamsie|
|Kali Aandhi|	|Kamleshwar|
|By God's Decree|	|Kapil Dev|
|Straight From Heart|	|Kapil Dev|
|Sadar-i-Riyasat|	|Karan Singh|
|Dark Debts|	|Karen Hall|
|A Contribution to the Critique of Political Economy|	|Karl Marx|
|Communist Manifesto|	|Karl Marx|
|Das Kapital|	|Karl Marx|
|Ship of Fools|	|Katherine Anne Porter|
|Indira–The Life of Indira Nehru Gandhi|	|Katherine Frank|
|Mother India|	|Katherine Mayo|
|Arthashastra|	|Kautilya|
|Agni Veena|	|Kazi Nazrul Islam|
|General Theory of Employment, Interest & Money|	|Keynes|
|Facts are Facts|	|Khan Abdul Wali Khan|
|A Bride for the Sahib and Other Stories|	|Khushwant Singh|
|Burial At Sea|	|Khushwant Singh|
|In the Company of Women|	|Khushwant Singh|
|Love, Truth and a Little Malice|	|Khushwant Singh|
|The Company of Women|	|Khushwant Singh|
|Bread, Beauty and Revolution|	|Khwaja Ahmed Abbas|
|Colonel Sun|	|Kingsley Amis|
|As I See|	|Kiran Bedi|
|It's Always Possible|	|Kiran Bedi|
|Cuckold|	|Kiran Nagar Kar|
|God's Little Soldier|	|Kiran Nagarkar|
|Mondays on Dark Night of Moon|	|Kirin Narayan|
|The 21st Century Ambassador|	|Kishan S. Rana|
|Meri Rahen Meri Manzil|	|Krishna Puri|
|Kamadhenu|	|Kubernath Ray|
|Between the Lines|	|Kuldip Nayar|
|Distant Neighbours|	|Kuldip Nayar|
|India–The Critical Years|	|Kuldip Nayar|
|Slaughter House Five|	|Kurt Vanuegut|
|Moonlight Sonata|	|L Beethoven|
|Fidelio|	|L. Beethoven|
|A Prisoner's Scrapbook|	|L. K. Advani|
|Anguish of Deprived|	|Lakshmidhar Mishra|
|Shivaji, The Great Patriot|	|Lala Lajpat Rai|
|Unhappy India|	|Lala Lajpat Rai|
|Beyond the Walls of Silence|	|Lalini Rajasuriya|
|Freedom at Midnight|	|Larry Collins and Dominique Lapierre|
|Is Paris Burning?|	|Larry Collins and Dominique Lapierre|
|Mountbatten and tne Partition of India|	|Larry Collins and Dominique Lapierre|
|O'Jerusalem|	|Larry Collins and Dominique Lapierre|
|Mountbatten and Independent India|	|Larry Collirs and Dominique Lapierre|
|India-Pakistan–History of Unsolved Conflicts|	|Lars Blinkenberg|
|Like Water for Chocolate|	|Laura Esquivel|
|Raj–The Making & Unmaking of British India|	|Lawrence James|
|Pakistan in the 20th Century–A Political History|	|Lawrence Ziring|
|A Revolutionary Life|	|Laxmi Sehgal|
|One-eyed Uncle|	|Laxmikant Mahapatra|
|Love in a Dead Language|	|Lee Seigel|
|China's Watergate|	|Leo Goodstadt|
|Anna Karenina|	|Leo Tolstoy|
|Resurrection|	|Leo Tolstoy|
|Rebirth|	|Leonid Brezhnev|
|Small Land|	|Leonid Brezhnev|
|Road to Folly|	|Leslie Ford|
|Alice in Wonderland|	|Lewis Carroll|
|And Through the Looking Glass|	|Lewis Carroll|
|Man, The Unknown|	|Lewis Carroll|
|Nursery Alice|	|Lewis Carroll|
|Pillow Problems and the Tangled Tale|	|Lewis Carroll|
|Ben Hur|	|Lewis Wallace|
|August 1914|	|Alexander Solzhenitsyn|
|Nai Duniya Ko Salam & Path or Ki Dewar|	|Ali Sardar Jafri|
|The Big Fisherman|	|Lloyd C. Douglas|
|Dynasties of India and Beyond–Pakistan, Sri Lanka and Bangladesh|	|lnder Malhotra|
|Idylls of the King|	|Lord Alfred Tennyson|
|In Memoriam|	|Lord Alfred Tennyson|
|Modern Jihad|	|Loretta Napuleoni|
|Rains Came|	|Louis Bromefieid|
|A Week with Gandhi|	|Louis Fischer|
|Gandhi and Stalin|	|Louis Fisher|
|Kailasb Mansarovar|	|Lt. Col. A. S. Berar (Retd.)|
|Pakistan Leadership Challenge|	|Lt. Gen. (Rtd.) Jahan Dad Khan|
|Surrender at Dacca|	|Lt. Gen. J. F.R. Jacob|
|Operation Bluestar–The True Story|	|Lt. Gen. K. S. Brar|
|Operation Parakaram–The War Unfinished|	|Lt. Gen. V. K. Sood and Pravin Sawhney|
|The Betrayal of East Pakistan|	|Lt. General A. A. K. Niazi|
|A Simple Path|	|Lucinda Vardey|
|Philosophical Investigations|	|Ludwig Wittgenstein|
|Man, Beast and Virtue|	|Luigi Pirandello|
|Six Characters in Search of an Author|	|Luigi Pirandello|
|Eminent Victorians|	|Lytton Strachey|
|Kabeer Aur Eesaayee Chintan|	|M. D. Thomas|
|Rags to Riches|	|M. G. Muthu|
|A Judge's Miscellany|	|M. Hidayatullah|
|My Own Boswell|	|M. Hidayatullah|
|Blood Brothers|	|M. J. Akbar|
|Kashmir–Behind the Vale|	|M. J. Akbar|
|Kargil–Cross Border Terrorism|	|M. K. Akbar|
|Open Secrets–Indian Intelligence Unveiled|	|M. K. Dhar|
|My Experiments with Truth|	|M. K. Gandhi|
|Conquest of Self|	|M. K. Gandhi|
|Hind Swaraj|	|M. K. Gandhi|
|Indian Home Rule|	|M. K. Gandhi|
|My Early Life|	|M. K. Gandhi|
|Non-Violence in Peace and War|	|M. K. Gandhi|
|Bureaucrazy|	|M. K. Kaw|
|Glimpses of Some Great Indians|	|M. L. Ahuja|
|Reminiscences of the Nehru Age|	|M. O. Mathai|
|India of Our Dreams|	|M. V. Kamath|
|Madame Secretary–A Memoir|	|Madeleine Albright|
|Quest for Conscience|	|Madhu Dandvate|
|Modernity, Morality And The Mahatma|	|MadhuriSanthanam Sondhi|
|Ramayana|	|Maharishi Valmiki|
|Magic Mountain|	|Maharishi Ved Vyas|
|Flash Point|	|Mainank Dhar|
|Saaket|	|Maithili Sharan Gupt|
|Saket|	|Maithili Sharan Gupt|
|Bharat Bharati|	|Maithili Sharan Gupta|
|Faces of Everest|	|Maj. H. P. S. Ahluwalia|
|Indian Arms Bazaar|	|Maj-Gen. Pratap Narain|
|Param Vir–Our Heroes in Battle|	|Major Gen. Ian Cardozo|
|Eternal Himalayas|	|Major H. P. S. Ahluwalia|
|In the Shadow of Pines|	|Mandeep Rai|
|Difficult Daughters|	|Manju Kapoor|
|Harvest|	|Manjula Padmanabhan|
|A Speaker's Diary|	|Manohar Joshi|
|A Bend in the Ganges|	|Manohar Malgonkar|
|Bandicoot Run|	|Manohar Malgonkar|
|Distant Drums|	|Manohar Malgonkar|
|Shalimar|	|Manohar Malgonkar|
|Farewell to a Ghost|	|Manoj Das|
|Dharamashastra|	|Manu|
|The Blind Assasin|	|Margaret Atwood|
|Halfway to Freedom|	|Margaret Bourke-White|
|Garrick Year|	|Margaret Drabble|
|Letters From the Field|	|Margaret Mead|
|Gone with the Wind|	|Margaret Mitchell|
|Path to Power|	|Margaret Thatcher|
|Lines of Fate|	|Mark Kharitonov|
|India's Unending Journey-How its Future will Affect Us All|	|Mark Tully|
|No Full Stops in India|	|Mark Tully|
|From Raj to Rajiv|	|Mark Tully and Zaheer Masani|
|Adventures of Huckleberry Finn|	|Mark Twain|
|Birds and Beasts|	|Mark Twain|
|The Adventures of Tom Sawyer|	|Mark Twain|
|Kiss of God|	|Marshall Stewart Bell|
|Havana Bay|	|Martin Cruz Smith|
|Nelson Mandela–A Biography|	|Martin Meredith|
|Chikaveera Rajendra|	|Masci Venkatesh Iyengar|
|Culture and Anarchy|	|Matthew Arnold|
|Essays in Criticism|	|Matthew Arnold|
|God and the Bible|	|Matthew Arnold|
|Sohrab and Rustam|	|Matthew Arnold|
|India Wins Freedom|	|Maulana Abul Kalam Azad|
|Blue Bird|	|Maurice Macterlink|
|Childhood|	|Maxim Gorky|
|Children of the Sun|	|Maxim Gorky|
|City of the Yellow Devil|	|Maxim Gorky|
|Enemies|	|Maxim Gorky|
|Mother|	|Maxim Gorky|
|Kiran Bedi–The Kindly Baton|	|Meenakshi Saxena|
|Life Isn't All Ha Ha Hee Hee|	|Meera Syal|
|Indica|	|Megasthenes|
|Development and Nationhood–Essays in the Political Economy of South Asia|	|Meghnad Desai|
|Jurassic Park|	|Michael Crichton|
|Platform|	|Michael Houellebecq|
|Moonwalk|	|Michael Jackson|
|Dude, Where's My Country?|	|Michael Moore|
|Killer Angels|	|Michael Shaara|
|And Quiet Flows the Don|	|Mikbail A. Sholokhov|
|Buddha's Warriors|	|Mikel Dunham|
|The August Coup|	|Mikhail S. Gorbachev|
|Life is Elsewhere|	|Milan Kundera|
|Bliss was it in that Dawn|	|Minoo Masani|
|China, the World and India|	|Mira Sinha Bhattacharjee|
|Bang-i-Dara|	|Mohammad Iqbal|
|Answer to History|	|Mohammad Reza Pahlavi|
|Atoms of Hope|	|Mohan Sundara Rajan|
|Brick Lane|	|Monica Ali|
|Story of My Life|	|Moshe Dayan|
|Aasman Aur Bhi Hain|	|Mridula Halan|
|My Own Witness|	|Mrinal Pande|
|Kanya–Exploitation of Little Angels|	|Ms. V. Mohini Giri|
|Little Angels|	|Ms. V. Mohini Giri|
|Regional Security in South Asia–The Ethno-Sectarian Dimensions|	|Muchkund Dubey & Nancy Jetly|
|Confessions of a Lover|	|Mulk Raj Anand|
|Lost Child|	|Mulk Raj Anand|
|Seven Summers|	|Mulk Raj Anand|
|The Bride's Book of Beauty|	|Mulk Raj Anand|
|The Bubble|	|Mulk Raj Anand|
|Godaan|	|Munshi Prem Chand|
|Kayakalp|	|Munshi Prem Chand|
|Prem Pachisi|	|Munshi Prem Chand|
|Rangbhoomi|	|Munshi Prem Chand|
|Soz-i-Watan|	|Munshi Prem Chand|
|Beast and Man|	|Murry NIidgley|
|Legacy of a Divided Nation|	|Mushirul Hasan|
|India's Priceless Heritage|	|N. A. Palkhivala|
|Naivedyam (The Offering)|	|N. Balamai Amma|
|Stripped Steel|	|N. K. Singh|
|Riding the Nuclear Tiger|	|N. Ram|
|Occasion for Loving|	|Nadine Gordimer|
|The Conservationist|	|Nadine Gordimer|
|A Himalayan Love Story|	|Namita Gokhale|
|The Book of Shadows|	|Namita Gokhale|
|Children of Gebelawi|	|Naquib Mahfouz|
|Faith & Compassion|	|Navin Chawla|
|A Voice of Freedom|	|Nayantara Sehgal|
|Indira Gandhi's Emergence and Style|	|Nayantara Sehgal|
|Mistaken Identity|	|Nayantara Sehgal|
|Prison and Chocolate Cake|	|Nayantara Sehgal|
|Rich Like Us|	|Nayantara Sehgal|
|The Day in Shadow|	|Nayantara Sehgal|
|Plans for Departure|	|Nayantata Sehgal|
|End of the Line|	|Neelesh IvIishra|
|173 Hours in Captivity|	|Neelesh Mishra|
|Long Walk to Freedom|	|Nelson Mandela|
|India's China War|	|Neville Maxwell|
|Government@net: New Governance, New Opportunities for India|	|New Governance, New Opportunities for India : Kiran Bedi, Parminder Jeet Singh & Sandeep Srivastava|
|Being Digital|	|Nicholas Negroponte|
|Story of Real Man|	|Nikolayev Polevoi|
|A Passage to England|	|Nirad C. Chaudhuri|
|Continent of Circe|	|Nirad C. Chaudhuri|
|Culture in the Vanity Bag|	|Nirad C. Chaudhuri|
|Scholar Extraordinary|	|Nirad C. Chaudhuri|
|The Autobiography of an Unknown Indian|	|Nirad C. Chaudhuri|
|Hinduism|	|Nirad C. Choudhuri|
|Democratic Governance in India–Challenges of Poverty, Development & Identity|	|Nirja Gopal Jayal & Sudha Pai|
|Bharat Aur Europe|	|Nirmal Verma|
|9-11|	|Noam Chomsky|
|Great Illusion|	|Norman Angell|
|Executioner's Song|	|Norman Mailer|
|Decline of the West|	|O' Spengler|
|Autumn Leaves|	|O. Pulla Reddi|
|Gurusagaram|	|O. V. Vijayan|
|A Tale of Two Gardens|	|Octavio Paz|
|In Light of India|	|Octavio Paz|
|Sun Stone|	|Octavio Paz|
|Deserted Village|	|Oliver Goldsmith|
|She Stoops to Conquer|	|Oliver Goldsmith|
|Rubaiyat|	|Omar Khayyam|
|De Profundis|	|Oscar Wilde|
|Importance of Being Earnest|	|Oscar Wilde|
|Damsel in Distress|	|P G. Wodehouse|
|Heavy Weather|	|P G. Wodehouse|
|Mass Media in Contemporary Society|	|P. B. Sawant|
|Perils of Democracy|	|P. C. Alexander|
|Flames from the Ashes|	|P. D. Tandon|
|Big Money|	|P. G. Wodehouse|
|French Leave|	|P. G. Wodehouse|
|Frozen Assets|	|P. G. Wodehouse|
|Fun Moon|	|P. G. Wodehouse|
|Girl in Blue|	|P. G. Wodehouse|
|Girl On the Boat|	|P. G. Wodehouse|
|Hot Water|	|P. G. Wodehouse|
|Thank You, Jeeves|	|P. G. Wodehouse|
|Indira Gandhi-The "Emergency" And Indian Democracy|	|P. N. Dhar|
|Premonitions|	|P. N. Haksar|
|Chithirappaavai|	|P. V. Akilandam|
|A Long Way|	|P. V. Narasimha Rao|
|Ayodhya–6 December 1992|	|P.V. Narasimha Rao|
|Guns & Yellow Roses-Essays on Kargil War|	|Pamela Constable|
|India Remembered–A Personal Account of the Mountbattens During the Transfer of Power|	|Pamela Mountbatten and India Hicks|
|Ashtadhyayi|	|Panini|
|India in Mind|	|Pankaj Mishra|
|Romantics|	|Pankaj Mishra|
|Temptations of the West–How to be Modern in India, Pakistan and Beyond|	|Pankaj Mishra|
|A Time of Coalitions|	|Paranjoy Guha Thakurta & Shankar Raghuraman|
|I Dare|	|Parmesh Dangwal|
|A Possible India|	|Partha Chatterjee|
|Mahabhashya|	|Patanjali|
|Hornet's Nest|	|Patricia Cornwell|
|Point of Origin|	|Patricia Cornwell|
|Liberty & Death|	|Patrick French|
|Shadow of a Princess|	|Patrick Jephson|
|Fire in the East–The Rise in Asian Military Power and the Second Nuclear Age|	|Paul Bracker|
|A Royal Duty|	|Paul Burrel|
|Cold Street|	|Paul Carson|
|Believe–Achieve|	|Paul Hanna|
|Preparing for the Twentieth Century|	|Paul Kennedy|
|Rise and Fall of the Great Powers|	|Paul Kennedy|
|Empire of the Soul–Some Journeys in India|	|Paul William Roberts|
|Double Betrayal|	|Paula R. Newburg|
|Special Tests–The Memoirs of an Unwanted Witness–A Soviet Spymaster|	|Pavel Anatolievich Sudoplatov|
|People Like Us|	|Pawan Kumar Verma|
|Being Indian|	|Pawan Varma|
|A House Divided|	|Pearl S. .Buck|
|All Under Heaven|	|Pearl S. Buck|
|Child Who Never Grew|	|Pearl S. Buck|
|China–Past and Present|	|Pearl S. Buck|
|Death in the Casde|	|Pearl S. Buck|
|Drogon's Seed|	|Pearl S. Buck|
|East Wind|	|Pearl S. Buck|
|Good Earth|	|Pearl S. Buck|
|Imperial Woman|	|Pearl S. Buck|
|Letter from Peking|	|Pearl S. Buck|
|Man Who Changed China|	|Pearl S. Buck|
|My Several Worlds|	|Pearl S. Buck|
|Pavilion of Women|	|Pearl S. Buck|
|The Beach Tree|	|Pearl S. Buck|
|The British Conquest and Dominion of India|	|Penderal Moon|
|Naked Came the Stranger|	|Penelope Ashe|
|India Remembered|	|Percival & Margaret Spear|
|Oscar and Lucinda|	|Peter Carey|
|A Tribute to People's Princess–Diana|	|Peter Donelli|
|The Changing World of the Executive|	|Peter Drucker|
|Managing for Results|	|Peter F. Drucker|
|Managing for the Future|	|Peter F. Drucker|
|Pyramids of Sacrifice|	|Peter L. Berger|
|Spy Catcher|	|Peter Wright|
|Operation Shylock|	|Philip Roth|
|Democracy Means Bread and Freedom|	|Piloo Mody|
|Once was Bombay|	|Pinki Virani One Day in the Life of Ivan Denisovich : Aleksandr Solzhenitsyn|
|Republic|	|Plato|
|Indian Judiciary–A Tribute|	|Poornima Advani .|
|Crossing the Threshold of Hope|	|Pope John Paul II|
|Millenniums|	|Pope John Paul II|
|South Asia on a Nuclear Fuse|	|Praful Bidwai & Achin Vanaik|
|Rediscovering Asia|	|Prakash Nanda|
|Development Banks-Infrastructure and Industrial Output|	|Prakash Salvi|
|Kohima to Kashmir–On Terrorist Trail|	|Prakash Singh|
|Beyond the Veil, Indian Women in the Raj|	|Pran Nevile|
|Britain's True History|	|Prem Bhatia|
|NirmaJa|	|Prem Chand|
|Identity and Violence–The Illusion of Destiny|	|Prof. Amartya Sen|
|India in Transition–Freeing the Economy|	|Prof. Jagdish Bhagwati|
|Nehru–A Political Life|	|Prof. Judith Brown|
|Manviya Sanskriti Ke Rachnatmak Aayam|	|Prof. Raghuvansh|
|Jankijeevanam|	|Prof. Rajendra Mishra|
|Honest Thief and Other Stories|	|Pyodor Dostoevsky|
|Malgudi Days|	|R, K Narayan|
|Death of a Patriot|	|R. E. Harrington|
|A TunnelofTime-AnAutobiography|	|R. K. Laxman|
|My Days|	|R. K. Narayan|
|Painter of Signs|	|R. K. Narayan|
|The Dark Room|	|R. K. Narayan|
|Chaitali|	|R. N. Tagore|
|Chithrangada|	|R. N. Tagore|
|Hindi Sahitya Aur Samvedna Ka Vikas|	|R. S. Chaturvedi|
|Environmental Economics–An Indian Perspective|	|Rabindra N. Bhattacharya|
|Bisarjan|	|Rabindranath Tagore|
|Chandalika|	|Rabindranath Tagore|
|Chitra|	|Rabindranath Tagore|
|Court Dancer|	|Rabindranath Tagore|
|Crescent Moon|	|Rabindranath Tagore|
|Gardener|	|Rabindranath Tagore|
|Gitanjali|	|Rabindranath Tagore|
|Gora|	|Rabindranath Tagore|
|Hungry Stones|	|Rabindranath Tagore|
|King of Dark Chamber|	|Rabindranath Tagore|
|Kshuditta Pashan (Hungry Stone)|	|Rabindranath Tagore|
|Lipika|	|Rabindranath Tagore|
|Post Office|	|Rabindranath Tagore|
|Silent Spring|	|Rachel Carson|
|Making Peace With Pakistan|	|Radha Kumar|
|Smell|	|Radhika Jha|
|Price of Partition|	|Rafiq Zakaria|
|Sardar Patel and Indian Muslims|	|Rafiq Zakaria|
|Gul-e-N aghma|	|Raghupati Sahai 'Firaq' Gorakhpuri|
|Rang-e-Shairi|	|Raghupati Sahai 'Firaq' Gorakhpuri|
|Saving Capitalism From The Capitalists|	|Raghuram G. Rajan and Luigi Zingales|
|2003 World Cup Cricket–Action Replay1983|	|Rahul Sehgal|
|Khushwant Singh...In the Name of the Father|	|Rahul Singh|
|The Blue Bedspread|	|Raj Kamal Jha|
|India Divided|	|Rajendra Prasad|
|Flight to Parliament|	|Rajesh Pilot|
|Eight Lives|	|Rajmohan Gandhi|
|Revenge and Reconciliation–Understanding South Asian History|	|Rajmohan Gandhi|
|Imdia Today|	|Rajni Palme Dutt|
|India Mter Gandhi–The History of World's Largest Democracy|	|Ram Chandra Guha|
|Ganganvani|	|Ram Karan Sharma|
|Katghare Main|	|Ram Sharan Joshi|
|How India Votes–Election Laws, Practice and Procedure|	|Rama Devi and S. K. Mendirata|
|My Presidential Years|	|Ramaswamy Venkataraman|
|Notebook of a Foot Soldier|	|Randhir Khare|
|Bewilderedlndia–Identity, Pluralism, Discord|	|Rasheeduddin Khan|
|Hacks And Headlines|	|Raslune Sehgal|
|My Music, My Love|	|Ravi Shankar|
|Hidden Iran–Paradox and Power in the Islamic Republic|	|Ray Takeyh|
|Meditations on First Philosophy|	|Rene Descrates|
|In Search of Gandhi|	|Richard Attenborough|
|Rethinking Early Modern India|	|Richard B. Barnett (Ed.)|
|Hero of Our Times|	|Richard Hough|
|Beyond Peace|	|Richard Nixon|
|Leaders|	|Richard Nixon|
|1999–Victory Without War|	|Richard Nixon|
|Escape the Night|	|Richard North Patterson|
|Jungle Book|	|Rildyard Kipling|
|Firefly–A Fairytale|	|Ritu Beri|
|Borders & Boundaries; Women in India's Partition|	|Ritu Menon & Kamla Bhasin|
|Raj Kapoor Speaks|	|Ritu Nanda|
|A Man for All Seasons|	|Robert Bolt|
|Nehru and the Language Politics of India|	|Robert D. King|
|JFK–An Unfinished Life|	|Robert Dallek|
|Nixon and Kissinger–Partners in Power|	|Robert Dallek|
|Stopping by Woods|	|Robert Frost|
|The Big Idea|	|Robert Jones|
|Dr. Jekyll and Mr. Hyde|	|Robert Louis Stevenson|
|Kidnapped|	|Robert Louis Stevenson|
|The Black Arrow|	|Robert Louis Stevenson|
|All the King's Men|	|Robert Penn Warren|
|The Birth of Europe|	|Robert S. Lopez|
|In Retrospect–The Tragedy and Lessons of Vietnam|	|Robert S. McNamara|
|Dancing with the Devil|	|Rod Barker|
|Paddy Clarke Ha, Ha, Ha|	|Roddy Doyle|
|The Commitments|	|Roddy Doyle|
|Family Matters: Rohinton|	|Rohinton :Mistry|
|A Fine Balance|	|Rohinton Mistry|
|In the Light of the Black Sun|	|Rohit Manchanda|
|Jean Christopher|	|Romain Rolland|
|Mahatma Gandhi|	|Romain Rolland|
|The Crisis in India|	|Ronald Segal|
|Kim|	|Rudyard Kipling|
|Light That Failed|	|Rudyard Kipling|
|Scenes from a Writer's Life|	|Ruskin Bond|
|For the Love of India|	|Russi M. Lala|
|A Backward Place|	|Ruth Prawer Jhabwala|
|Heat and Dust|	|Ruth Prawer Jhabwala|
|Assassination of a Prime Minister|	|S. Anandram|
|From India to America|	|S. Chandrashekhar|
|Dialogue With Pakistan|	|S. G. Kashika|
|A Sense of Time|	|S. H. Vatsyayan|
|Kamasutra|	|S. H. Vatsyayan|
|Children and Human Rights|	|S. K. Pachuri|
|Oru Desathinte Katha|	|S. K. Pottekkatt|
|Economics of the Third World|	|S. K. Ray|
|After the Dark Night|	|S. M. Ali|
|Indira's India|	|S. Nihal Singh|
|My India|	|S. Nihal Singh|
|Bhagvad Gita|	|S. Radhakrishnan|
|Gandhi–A Sublime Failure|	|S. S. Gill|
|A Conceptual Encyclopaedia of Guru Gtanth Sahib|	|S. S. Kohli|
|Don Quixote|	|Saavedra Miguel de Cervantes|
|In Mghanistan's Shadow|	|Salig S. Harrison|
|East West|	|Salman Rushdie|
|Fury|	|Salman Rushdie|
|Ground Beneath Her Feet|	|Salman Rushdie|
|Jaguar Smile|	|Salman Rushdie|
|Satanic Verses|	|Salman Rushdie|
|Shalimar The Clown|	|Salman Rushdie|
|Shame|	|Salman Rushdie|
|Netaji–Dead or Alive|	|Samar Guha|
|Dream of Fair to Middling Women|	|Samuel Beckett|
|Erewhon|	|Samuel Butler|
|Essay on Life|	|Samuel Butler|
|The Clash of Civilisations and the Remaking of World Order|	|Samuel Huntington|
|Christabel|	|Samuel Taylor Coleridge|
|Confessions of an Inquiring Spirit|	|Samuel Taylor Coleridge|
|Kubla Khan|	|Samuel Taylor Coleridge|
|India's Rise to Power in the Twentieth Century & Beyond|	|Sandy Gordon|
|The Career & Legend of Vasco de Gama|	|Sanjay Submmanyam|
|Brideless in Wembley|	|Sanjay Suri|
|Indian Mansions|	|Sarah Tillotson|
|Operation Black Thunder|	|Sarbjit Singh|
|Broken Wings|	|Sarojini Naidu|
|Golden Threshold|	|Sarojini Naidu|
|Sceptred Flute|	|Sarojini Naidu|
|Last Analysis|	|Saru Bellow|
|A Search for Home|	|Sasthi Brata|
|My God Died Young|	|Sasthi Brata|
|Kashmir Underground|	|Sati Sahni|
|A Brush with Life|	|Satish Gujral|
|The Buddha & The Terrorist|	|Satish Kumar|
|Our Films, Their Films|	|Satyajit Ray|
|Dangling Man|	|Saul Bellow|
|Dean's December|	|Saul Bellow|
|Henderson the Rain King|	|Saul Bellow|
|Samler's Planet|	|Saul Bellow|
|Future of NPT|	|Savita Pande|
|Personal Injuries|	|Scot Turow|
|Pleading Guilty|	|Scott Turow|
|North|	|Seamus Heaney|
|J. K.-Biography of J. K. Rowling|	|Seen Smith|
|The Dark Side of Camelot|	|Seymore Hersh|
|Dark Side of Camelot|	|Seymour Hersh|
|Price of Power–Kissingerin the Nixon White House|	|Seymour M. Hersh|
|Sher-e-Shor Angez|	|Shamsur Rahman Faruqi|
|Can India Grow Without Bharat|	|Shankar Acharya|
|A Gift of Wings|	|Shanthi Gopalan|
|Pratham Pratishruti|	|Ashapurna Devi|
|Devdas|	|Sharat Chandra Chatterjee|
|Small Remedies|	|Shashi Deshpande|
|India–From Midnight to the Millennium|	|Shashi Tharoor|
|Friends and Foes|	|Sheikh Mujibur Rehman|
|Gulistan Bostan|	|Sheikh Saadi|
|Canvas of Life|	|Sheila Gujral|
|Iran Awakening–A Memoir of Revolution and Hope|	|Shirin Ebadi|
|Neela Chand|	|Shiv Prasad Singh|
|Mrityunjaya|	|Shivaji Sawant|
|Socialite Evenings|	|Shobhaa De|
|Speed Post|	|Shobhaa De|
|Spouse|	|Shobhaa De|
|Starry Nights|	|Shobhaa De|
|Sultry Days|	|Shobhaa De|
|Surviving Men|	|Shobhaa De|
|Mrichchhakatikam|	|Shudraka|
|Saddam's Bomb|	|Shyam Bhatia and Daniel McGrory|
|Sands of Time|	|Sidney Sheldon|
|Rape of Nanking (Nanjing)–An Undeniable History of Photographs|	|SIll Young|
|Living History–An Autobiography of Hillary Rodham Clinton|	|Simon & Schuster|
|Main Street|	|Sinclair Lewis|
|Adventures of Sherlock Holmes|	|Sir Arthur Conan Doyle|
|Poison Belt|	|Sir Arthur Conan Doyle|
|Tales of Sherlock Holmes|	|Sir Arthur Conan Doyle|
|Ascent of the Everest|	|Sir John Hunt|
|India in Slow Motion|	|Sir Mark Tully|
|Arabian Nights|	|Sir Richard Burton|
|Book of the Sword|	|Sir Richard Burton|
|City of Saints|	|Sir Richard Burton|
|Nile Basin|	|Sir Richard Burton|
|Ivanhoe|	|Sir Walter Scott|
|Kenilworth|	|Sir Walter Scott|
|Lady of the Lake|	|Sir Walter Scott|
|Talisman|	|Sir Walter Scott|
|Beyond Modernisation, Beyond Self|	|Sisir Kumar Ghose|
|The Afghan Turmoil–Changing Equations|	|Sreedhar & Mahendra Dev|
|One World to Share|	|Sridath Ramphal|
|A Tryst With Destiny|	|Stanley Wolfer|
|Red and Black|	|Stendhal|
|A Brief History of Time|	|Stephen Hawking|
|Black Holes and Baby Universes|	|Stephen Hawking|
|Cell|	|Stephen King|
|Out of My Comfort Zone|	|Steve Waugh|
|Engaging India–Diplomacy, Democracy & the Bomb|	|Strobe Talbott|
|India's China Perspective|	|Subramanian Swamy|
|O is for Outlaw|	|Sue Grafion|
|Modern South Asia–History, Culture, Political Economy|	|Sugata Bose & Ayesha Jalal|
|Maximum City|	|Suketu Mehta|
|A Sin of Colour|	|Sunetra Gupta|
|Idols|	|Sunil Gavaskar|
|Sunny Days|	|Sunil Gavaskar|
|Single in the City–The Independent Woman's Handbook|	|Sunny Singh|
|Mrs. De Winter|	|Susan Hill|
|After All These Years|	|Susan Issacs|
|Something Barely Remembered|	|Susan Visvanathan|
|Long Shadow–Inside Stalin's Family|	|Svetlana Allilyuyeva|
|Satyartha Prakash|	|Swami Dayanand|
|Divine Life|	|Swami Sivananda|
|Beyond Boundaries-A Memoire|	|Swraj Paul|
|Rage of Angels|	|Sydney Sheldon|
|Murder in the Cathedral|	|T. S. Eliot|
|The Cocktail Party|	|T. S. Eliot|
|The Confidential Clerk|	|T. S. Eliot|
|Pulsating Presence of a Painful Past|	|Taisha Abraham|
|Dust to Dust|	|Tami Hoag|
|Perceptions, Emotions Sensibilities|	|Tapan Raychaudhuri|
|Ganadevata|	|Tara Shankar Bandopadhyaya|
|Freedom Behind Bars|	|Tarsem Kumar|
|The Alchemy of Desire|	|Tarun J. Tejpal|
|Koraner Nari|	|Taslima Nasreen|
|Lajja|	|Taslima Nasreen|
|Nirbashita Narir Kabita|	|Taslima Nasreen|
|Prospects for Democracy in Asia|	|Tatu Vanhanen|
|Kashmir–A Tragedy of Errors|	|Tavleen Singh|
|India Changes|	|Taya Zinkin|
|Disappearing Acts|	|Terry McMillan|
|Mama|	|Terry McMillan|
|Fifth Elephant|	|Terry Pratchett|
|Chemmeen|	|Thakazhi Sivasankara Pillai|
|India Betrayed|	|The Role of Nehru : B. N. Sharma|
|An American Tragedy|	|Theodore Dreiser|
|A Personal Adventure|	|Theodore H. White|
|Old Path–White Clouds|	|Thich Nht Hanh|
|Summa Theologica|	|Thomas Aquinas|
|French Revolution|	|Thomas Carlyle|
|Heroes and tIero Worship|	|Thomas Carlyle|
|Past and Present|	|Thomas Carlyle|
|Reminiscences|	|Thomas Carlyle|
|The Confessions of an English Opium Eater|	|Thomas De Quincy|
|Churchyard|	|Thomas Gray|
|A Pair of Blue Eyes|	|Thomas Hardy|
|Far From the Madding Crowd|	|Thomas Hardy|
|Tess of D'Urbervilles|	|Thomas Hardy|
|Hannibal|	|Thomas Harris|
|Leviathan|	|Thomas Hobbes|
|Schindler's List|	|Thomas Keneally|
|Death in Venice|	|Thomas Maim|
|Common Sense|	|Thomas Paine|
|Rights of Man|	|Thomas Paine|
|Men Who Kept the Secrets|	|Thomas Powers|
|Europa|	|Time Parks|
|War and Piece|	|Tolstoy|
|Every Man a Tiger|	|Tom Clancy|
|Line of Control|	|Tom Clancy & Steve Pieceznik|
|Santa Evita|	|Tomas Eloymartinez|
|Kaleidoscope of India|	|Tomoji Muto|
|Beloved|	|Toni Morrison|
|In the Bluest Eye|	|Toni Morrison|
|Jazz|	|Toni Morrison|
|Song of Solomon|	|Toni Morrison|
|Sula|	|Toni Morrison|
|Tar Baby|	|Toni Morrison|
|Ram Charita Manas|	|Twsidas|
|Dragon's Teeth|	|U. B. Sinclair|
|Nisheeth|	|Uma Shankar Joshi|
|Last Burden|	|Upamanyu Chatterjee|
|I Will Lie Down in Peace|	|Usha Jesudasan|
|Afghanistan & Asian Stability|	|V D. Chopra|
|India–A Wounded Civilisation|	|V S. Naipaul|
|Democracy Redeemed|	|V. K. Narsimhan|
|Food, Nutrition and Poverty in India|	|V. K. R. V. Rao|
|I Muse; Therefore I Am|	|V. N. Narayanan|
|Lolita|	|V. Nabokov|
|Laws Versus Justice|	|V. R. Krishna lyer|
|A Bend in the River|	|V. S. Naipaul|
|A Million Mutinies Now|	|V. S. Naipaul|
|An Area of Darkness|	|V. S. Naipaul|
|Beyond Belief|	|V. S. Naipaul|
|Half a Life|	|V. S. Naipaul|
|India–A Million Mutinies Now|	|V. S. Naipaul|
|Letters Between a Father and Son|	|V. S. Naipaul|
|Magic Seeds|	|V. S. Naipaul|
|Miguel Street|	|V. S. Naipaul|
|Jobs for Millions|	|V. V. Giri|
|My Life and Times|	|V. V. Giri|
|Stolen Harvest|	|Vandana Shiva|
|A Peep into the Past|	|Vasant Navrekar|
|Charisma & Cannon–Essays on the Religious History of Subcontinent|	|Vasudha Dalmia, Angelika Malinar and Marcin Christ|
|Portrait of India|	|Ved Mehta|
|Rahul Dravid–A Biography|	|Vedam Jaishankar|
|Les Miserables|	|Victor Hugo|
|Kashmir in the Crossfire|	|Victoria Shaffield|
|Devi–The Great Goddess|	|Vidya Dahejia|
|Pak Proxy War|	|Vijay Karan|
|Kanyadaan|	|Vijay Tendulkar|
|Sakharam Binder|	|Vijay Tendulkar|
|From Rajpath to Lokpath|	|Vijaya Raje Scindia|
|Ritu Ka Pehla Phool|	|Vijendra|
|Love and Longing in Bombay|	|Vikram Chandra|
|Sacred Games|	|Vikram Chandra|
|A Suitable Boy|	|Vikram Seth|
|An Equal Music|	|Vikram Seth|
|Arion and the Dolphin|	|Vikram Seth|
|Mudrarakshasa|	|Vishakhadatta|
|Panchatantra |	|Vishnu Sharma|
|A Last Leap South|	|Vladimir Zhirinovsky|
|Candide|	|Voltaire|
|Moon and Six Pence|	|W Somerset Maugham|
|Of Human Bondage|	|W Somerset Maugham|
|Painted Veil|	|W Somerset Maugham|
|Razor's Edge|	|W Somerset Maugham|
|Leaves of Grass|	|Walt Whitman|
|In the Stream of History–Shaping Foreign Policy for a New Era|	|Warren Christopher|
|One World|	|Wendell Wilkie|
|A View from Outside|	|Why Good Economics Works for Everybody : P. Chidambaram|
|Monsoon|	|Wilbur Smith|
|King Lear|	|Wilham Shakespeare|
|Angry Letters|	|Willem Doevenduin|
|Critical Mass|	|William E. Burrows|
|Flags in the Dust|	|William Faulkner|
|Go Down Moses|	|William Faulkner|
|Intruder in the Dust|	|William Faulkner|
|Sanctuary|	|William Faulkner|
|Double Tongue|	|William Golding|
|Lord of the Flies|	|William Golding|
|Spirit of the Age|	|William Hazlitt|
|Henry Esmond|	|William M. Thackeray|
|Death of a President|	|William Manchester|
|A Midsummer Night's Dream|	|William Shakespeare|
|All Is Well That Ends Well|	|William Shakespeare|
|Antony and Cleopatra|	|William Shakespeare|
|As You Like It|	|William Shakespeare|
|Comedy of Errors|	|William Shakespeare|
|Hamlet|	|William Shakespeare|
|Julius Caesar|	|William Shakespeare|
|Macbeth|	|William Shakespeare|
|Much Ado About Nothing|	|William Shakespeare|
|Othello|	|William Shakespeare|
|Romeo and Juliet|	|William Shakespeare|
|Prelude|	|William Wordsworth|
|An Admiral's Fall|	|Wilson John|
|Gathering Storm|	|Winston Churchill|
|The Changing Global Order|	|World Leaders Reflect : Nathan Gardels|
|My Father, Deng Xiaoping|	|Xiao Rong|
|Carnage By Angels|	|Y P. Singh|
|Life of Pi|	|Yann Martel|
|Confessions of a Swadeshi Reformer–My Years as Finance Minister|	|Yashwant Sinha|
|Snow Country|	|Yasunari Kawabata|
|Rediscovering Gandhi|	|Yogesh Chadha|
|Bin Laden–The Man Who Declared War on America|	|Yossef Bodansky|
|The Cinemas of India|	|Yves Thoraval|
|Great Tragedy|	|Z. A. Bhutto|
|If I Am Assassinated|	|Z. A. Bhutto|
|Glimpses of Indian Ocean|	|Z. A. Quasim|
